1
50 20 12 3 1 1300 390 3 1


1
50 20 2 3 2 1300 390 1 1

1
50 20 3 3 1 1000 390 1 1

1
50 20 4 3 2 1000 390 1 1

1
50 20 5 3 1 1000 390 1 1

1
50 20 6 3 2 1000 390 1 1

1
50 20 7 3 1 1000 390 1 1

1
50 20 8 3 2 1000 390 1 1

1
50 20 9 3 1 1000 390 1 1

2
50 20 3 3 1 1000 390 1 1
50 20 6 3 1 1000 390 1 1

2
50 20 4 3 1 1000 390 1 1
50 20 7 3 1 1000 390 1 1

2
50 20 5 3 1 1000 390 1 1
50 20 8 3 1 1000 390 1 1

2
50 20 6 3 1 1000 390 1 1
50 20 9 3 1 1000 390 1 1

3
50 20 1 1 1 1000 390 1 1
50 20 2 1 1 1000 390 1 1
50 20 3 1 1 1000 390 1 1

4
50 20 1 1 1 1000 390 1 1
50 20 2 1 1 1000 390 1 1
50 20 3 1 1 1000 390 1 1
50 20 4 1 1 1000 390 1 1

5
50 20 1 1 1 1000 390 1 1
50 20 2 1 1 1000 390 1 1
50 20 3 1 1 1000 390 1 1
50 20 4 1 1 1000 390 1 1
50 20 5 1 1 1000 390 1 1

6
50 20 1 1 1 1000 390 1 1
50 20 2 1 1 1000 390 1 1
50 20 3 1 1 1000 390 1 1
50 20 4 1 1 1000 390 1 1
50 20 5 1 1 1000 390 1 1
50 20 6 1 1 1000 390 1 1

7
50 20 1 1 1 1000 390 1 1
50 20 2 1 1 1000 390 1 1
50 20 3 1 1 1000 390 1 1
50 20 4 1 1 1000 390 1 1
50 20 5 1 1 1000 390 1 1
50 20 6 1 1 1000 390 1 1
50 20 7 1 1 1000 390 1 1

8
50 20 1 1 1 1000 390 1 1
50 20 2 1 1 1000 390 1 1
50 20 3 1 1 1000 390 1 1
50 20 4 1 1 1000 390 1 1
50 20 5 1 1 1000 390 1 1
50 20 6 1 1 1000 390 1 1
50 20 7 1 1 1000 390 1 1
50 20 8 1 1 1000 390 1 1

9
50 20 1 1 1 1000 390 1 1
50 20 2 1 1 1000 390 1 1
50 20 3 1 1 1000 390 1 1
50 20 4 1 1 1000 390 1 1
50 20 5 1 1 1000 390 1 1
50 20 6 1 1 1000 390 1 1
50 20 7 1 1 1000 390 1 1
50 20 8 1 1 1000 390 1 1
50 20 9 1 1 1000 390 1 1

9
50 20 1 2 1 1000 390 1 1
50 20 2 2 1 1000 390 1 1
50 20 3 1 1 1000 390 1 1
50 20 4 2 1 1000 390 1 1
50 20 5 1 1 1000 390 1 1
50 20 6 2 1 1000 390 1 1
50 20 7 1 1 1000 390 1 1
50 20 8 2 1 1000 390 1 1
50 20 9 1 1 1000 390 1 1

6
50 20 1 2 1 1000 390 1 1
50 20 2 1 1 1000 390 1 1
50 20 3 2 1 1000 390 1 1
50 20 4 1 2 1000 390 1 1
50 20 5 1 1 1000 390 1 1
50 20 6 2 1 1000 390 1 1

6
50 20 1 1 1 1000 390 1 1
50 20 2 1 3 1000 390 1 1
50 20 3 1 1 1000 390 1 1
50 20 4 1 1 1000 390 1 1
50 20 5 1 2 1000 390 1 1
50 20 6 2 1 1000 390 1 1


6
50 20 4 1 1 1000 390 1 1
50 20 7 1 1 1000 390 1 1
50 20 5 1 1 1000 390 1 1
50 20 8 1 1 1000 390 1 1
50 20 6 1 1 1000 390 1 1
50 20 9 1 1 1000 390 1 1

6
50 20 4 2 1 1000 390 1 1
50 20 7 2 1 1000 390 1 1
50 20 5 1 1 1000 390 1 1
50 20 8 3 1 1000 390 1 1
50 20 6 1 1 1000 390 1 1
50 20 9 1 2 1000 390 1 1

7
150 20 4 2 1 1000 390 1 1
50 20 7 2 1 1000 390 1 1
300 200 5 1 1 1000 390 1 1
20 20 8 3 1 1000 390 1 1
300 20 6 1 1 1000 390 1 1
50 200 9 1 2 1000 390 1 1
50 20 9 3 2 1000 390 1 1

